. . . # . . . . . .
# # . # . # # # . .
. . . . . . . # . C
# . # # # . # # # #
. . . . # . . . . .
# # . . # . # . # #
. . . . . . # . . #
# # . # # . . . . .
. . . . # # # . # #
# . # S . . . . . #
